
a            *  t *         ~                    ~                         * t  *                    c               *  t   t  *                              *t *         ~           f
""            """"         """                 """"       "      """        """"       ""       """"""""""""          """""""""                 ""           """"         ""         """
""            """"         """                 """"       "      """        """"       ""       """"""""""""          """""""""                 ""           """"         """        """
""            """"         """                 """"       "      """        """"       ""       """"""""""""          """""""""        ""       ""           """"         """"       """
"""""         """"         """               """"""       "      """        """"       ""       """"""""""""          """""""""        ""       ""           """"         """"       """
"""""         """"        """""              """"""       "      """        """"       ""       """"""""""""          """""""""        ""       ""           """"""       """"       """
"""""         """"        """""              """"""       "      """        """"       ""       """"""""""""          """""""""        ""       ""           """"""       """"       """
"""""         """"        """""     "        """"""       "      """        """"       ""       """"""""""""          """""""""        ""       ""           """"""       """"       """
