  
                                                     *     t     *                                                                                              ########    #############
                            c             ########################################                                                                                     #    #           #
                          ######         ####                                    #              c                                                           ###        #    #           #
                                        #####                                    #            ####                    ####                                             #                #
        ###                            ######                                    #                                                                      ###            #                #
     a    *    e    *                 #######                                    #   e   *             *  e   *                                                        #*   e    *     f#
  ###########################################                                    ########               ######                      #################                  ##################
