                                                      ~        ~      c                            ~        *  b  *       *  t  *           ~
                                               #######          ########                       ########      #####         #####         #######                   
                                      *  u *                                     *  b  *                                                             *  s   u  *
                                       ####                                       #####                             ######                           ##########
    #                       ####
    #
  a #  s    k   *       *    t    u  *      * r * c ~               *  t  * * s  *                 c    ~         ~      * t *               * k  u  *             f
#####################################       #### ####    ########    ############       ####     ####   #  ####  ##       ###      ###        #######        ######## 
