  
                                                     *     t     *
                                          ########################################
                #         ######         ####
                                        #####
                                       ######
  a                                   #######
  ###########################################
