a
################   *   r   *
###############     #######    *     r   *                                                                    *    r           f *
##############                  #########                     *   r  *              ~                          ##################
#############                                                  ######
#                                                    ~               
#                 ~      *       r       *      c ############                                               ##
#~r r          *####      ###############     ################~~      r     *       ##                *    r ##
################                              ####################################        #########    ########
