  
                                             ~       *     t     *                                                                                              ########    #############
                            c             ########################################                                                                                     #    #           #
                          ######         ####                                    #              c                                                           ###        #    #           #
           ~                            #####                                    #            ####                    ####                                             #                #
        ###                            ######                                    #                                                                      ###            #                #
  a       *    brsktu        *        #######                                    #   e   *             *  e   *                                                        #*   e    *     f#
  ###########################################                                    ########               ######                      #################                  ##################
