                                                                                                                                                                               ~~~~~ 
                                                     *     r     *                                                                                                          #############
                            c             ###         ############################                                                                                          #           #
                          ######         ####           ~~~~                                    c                                                           ###             #           #
                                        #####           ####      ~~                          ####                    ####                                             #                #
        ###                            ######                     ##                                                                                    ###            #                #
     a    *    r    *                 #######                              ##   *    r   *             *  r   *                                                        #*   r    *     f#
  ###########################################                                    ########               ######                      #################                  ##################
