  
                                                     *     r     *                                                                                              ########    #############
                            c             ########################################                                                                                     #    #           #
                          ######         #########################################              c                                                           ###        #    #           #
                                        ##########################################            ####                    ####                                             #                #
        ###                            ###########################################                                                                      ###            #                #
   a      *    r    *                 ############################################   r   *              *  r   *                                                       #*   e    *     f#
  ########################################################################################               ######                      #################                 ##################
