
                                                         t
                                        ########################################
              #         ######         ####
                                      #####
                                     ######
a    e                              #######
####################  #####################
