


a          * u *    ~                 ~               * u *                 * u *                 ~                                                                 * u *        ~      ~           f
#     # #   ###     #      #    #     #       # ###    ###   # #    #   #   #######    # #    #   #      #   #    #                           ## #    # #   #   ##   ###   # #   #      #   # #     #
#     # #   ###     #      #    #     #       # ###    ###   # #    #   #   #######    # #    #   #      #   #    #              c            ## #    # #   #   ##   ###   # #   #      #   # #     #
#     # #   ###     #      #    #     #       # ###    ###   # #    #   #   #######    # #    #   #      #   #    #       ###############     ## #    # #   #   ##   ###   # #   #      #   # #     #
#     # #   ###     #      #    #     #       # ###    ###   # #    #   #   #######    # #    #   #      #   #    #       ###############     ## #    # #   #   ##   ###   # #   #      #   # #     #
                             