
a                                                                                            ###########                                            #
#                                      #############################                                   #                                            #
#                                                                                   ######             #                                            #
#       #    u              #           ~               ~                     ####                     #            ~           ~           ~       #
#       ########            #                    #                *u*   ####                           #                                            #
#   u   #      #  u   u   u #     #    u   u     #   u   u    u    #                                   #   uuu   u u      u     u     u f  u   u    #
#############################     ##################################                                   ##############################################
