  
                                                           t
                                          ########################################
                #         ######         ####
                                        #####
                                       ######
  a                              e    #######
  ###########################################
