  
                                                     *     t     *                                                                                              ########    #############
                                          ########################################                                                                                     #    #           #
                          ######         ####                                    #                                                                          ###        #    #           #
                                        #####                                    #            ####                    ####                                             #                #
        ###                            ######                                    #                                                                      ###            #                #
  a       *    e    *                 #######                                    #   e   *             *  e   *                                                        #*   e    *      #
  ###########################################                                    ########               ######                      #################                  ##################
