################                           *  u    u    *                                                       ~
#             ##                            ############                                                        #
#             ##                     ~                                                   c                      #u           *
#  *  u   u  f##                  #######                     ~                         ###                     ############# 
#  #############                                         ##########                                                                      *     u      u      *
#                                                                                                                                         ###################
#                   ###########                 c                                * u u u *               u     *          * u *                                   a
# u    *   u     *                          ########                       ##########################################      #######################     ##################
##################
