################                           *  u    u    *                                                       ~
#             ##                            ############                                                        #
#             ##                     ~                                                   c                      #
#  *  u   u  f##                  #######                     ~                         ###                     #u           *
#  #############                                         ##########                                             #############            *     u      u      *
#                                                                                                                                         ###################
#                   ###########                 c                                * u u u *               u     *          * u *                                   a
# u    *   u     *                          ########                       ##########################################      #######################     ##################
##################
