                                                      ~        ~      c                            ~        *  u  *       *  u  *           ~
                                               #######          ########                       ########      #####         #####         #######                   
                                      *  u *                                     *  u  *                                                             *  u   u  *
                                       ####                                       #####                             ######                           ##########
    #                       ####
    #
  a #  u    u   *       *    u    u  *      * u * c ~               *  u  * * u  *                 c    ~         ~      * u *               * u  u  *             f
#####################################       #### ####    ########    ############       ####     ####   #  ####  ##       ###      ###        #######        ######## 
